┌──────────────────────────────────────┐
│^{map2.map}                                     │
│   v{map3.map}                                  │
│       m{map4.map}                              │
│                                      │
│                                      │
│                                      │
│                                      │
│                         *            │
└──────────────────────────────────────┘
