┌────────┐
│^{map2.map}       │
│        │
│        │
│        │
│        │
│        │
│        │
│        │
│        │
│       ^{map2.map}│
└────────┘
