┌────────────────────────────┐
│                            │
│                            │
│                            │
│                            │
│                            │
│                            │
│                            │
│                            │
│                            │
│                            │
│                            │
│                            │
│                            │
│                            │
│                            │
│                            │
│                            │
│                            │
│                            │
│                            │
│                            │
│                            │
│                            │
│                            │
│                            │
│                            │
│                            │
│                           ^{map1.map}│
└────────────────────────────┘
