┌──────────────────────────────────────┐
│^{map2.map}                                     │
│   v{map1.map}                                  │
│       m{map4.map}                              │
│                                      │
│                                      │
│                                      │
│                                      │
│                         *            │
└──────────────────────────────────────┘
