┌──────────────────────────────────────┐
│^{map1.map}                                     │
│   v{map3.map}                                  │
│       m{map2.map}                              │
│                                      │
│                                      │
│                                      │
│                                      │
│                         *            │
└──────────────────────────────────────┘
