┌─────────────┐
│             │
│    #{mapa2.map}         │
│             │
│             │
│             │
│             │
│             │
│             │
└─────────────┘
