┌─────────────────────────────────────────────────────────────┐
│                                                             │
│                                                             │
│                                                             │
│                                                             │
│                                                             │
│                                                             │
│                                                             │
│                                                             │
│                                                             │
│                                                             │
│                                                             │
│                                                             │
│                                                             │                                                             │
│                                                             │
│                                                             │
│                                                             │
└─────────────────────────────────────────────────────────────┘